|---------------------------|
| #  |                    X |
|    |  *                   |
|    |                      |
| *  |----------            |
|                           |
|                           |
|         ---               |
|---------| |          ---- |
|         ---         |     |
|                     |  @  |
|---------------------------|