|---------------------------|
|@   |                    X |
|    |                      |
|    |-------------- .      |
|-  -|                      |
|                      -----|
|                           |
|                      |    |
|-------------------------  |
|  #      |           |     |
|               |           |
|---------------------------|
