                             
      --     --              
     / #\   /  \             
    /    \_/ *  \            
   /             \           
  /  *            \          
 /                 \         
/---  ----X----  ---\        
\                   /        
 \       @         /         
  \---------------/          
                             
                             
                              