|---------------------------|
|    |      *               |
|    |                      |
|    |     -------          |
|----|     |     |       #  |
|          |     |     -----|
|          |     |     |    |
|          |     |     |    |
|          |     |     -----|
|          |     |          |
|   @      |     |       X  |
|---------------------------|