|---------------------------|
|                           |
|         You Died!         |
|                           |
|Press [ENTER] to start over|
|                           |
|                           |
|                           |
|                           |
|                           |
|---------------------------|