  ----------------           
 / *             \           
|                 \          
|       /\         \         
|      /  \         \        
|     /    \         \       
| @  / |----\         \      
|   /  | #             \     
|  /   |------\         \    
| /            \         \--|
|/              \          X|
|                -----------|