         /----  ------------|
        / #  /  \         X |
|------/    /    \          |
| @        /      \         |
|          |      |         |
|-----     |      |         |
      \    \      /         |
       \    \    /          |
        \    \  /           |
         \    \/     -------|
          \               * |
           -----------------|