    /-------------------\    
   /          X       #  \   
  /                       \  
 /                         \ 
/                           \
|    *                *     |
|                           |
\                           /
 \                         / 
  \                       /  
   \          @          /   
    \-------------------/     