                            
                             
    -------                  
   /       \                 
  / @       \                
 /           \               
/    .---     \              
\ #           /              
 \_/       \_/               
   |     X |                 
   |-------|                 
                             