    /-------------------\    
   /      |              \   
  / X           *         \  
 /        |                \ 
/---------|---. ----  ------\
|    *                      |
|          |                |
\          |                /
 \----------         *     / 
  \                       /  
   \          @          /   
    \-------------------/     