|---------------------------|
|                           |
|         YOU WON!          |
|                           |
|Press [ENTER] to start over|
|                           |
|                           |
|                           |
|                           |
|                           |
|---------------------------|